%%%%%%%%%%%%%%%%%%%%
%%%%%%%%%%%%%%%%%%%%
%%%############%%%%%
%%%#XX  #     ###%%%
%%%#XX  # E  E  #%%%
%%%#XX  #E####  #%%%
%%%#XX    P ##  #%%%
%%%#XX  # #  E ##%%%
%%%###### ##E E #%%%
%%%%%# E  E E E #%%%
%%%%%#    #     #%%%
%%%%%############%%%
%%%%%%%%%%%%%%%%%%%%