%%%%%%%%%%%%%%%%%%%%
%%%%%%%%%%%%%%%%%%%%
%%%%%%%%%%########%%
%%%%%%%%%%#     P#%%
%%%%%%%%%%# E#E ##%%
%%%%%%%%%%# E  E#%%%
%%%%%%%%%%##E E #%%%
%%######### E # ###%
%%#XXXX  ## E  E  #%
%%##XXX    E  E   #%
%%#XXXX  ##########%
%%########%%%%%%%%%%
%%%%%%%%%%%%%%%%%%%%
%%%%%%%%%%%%%%%%%%%%
%%%%%%%%%%%%%%%%%%%%