%%%%%####%%%%%%%%%%%
%%%%%#  #%%%%%%%%%%%
%%%%%#  #%%%%%%%%%%%
%#####  ###%%%%%%%%%
%# E XE   #%%%%%%%%%
%# PEAX A #%%%%%%%%%
%# AXA  ###%%%%%%%%%
%###   ##%%%%%%%%%%%
%%%#   #%%%%%%%%%%%%
%%%#   #%%%%%%%%%%%%
%%%#####%%%%%%%%%%%%
%%%%%%%%%%%%%%%%%%%%
%%%%%%%%%%%%%%%%%%%%
%%%%%%%%%%%%%%%%%%%%
%%%%%%%%%%%%%%%%%%%%