%%%%%%%%%%%%%%%%%%%%
%%%%%%%%%%%%%%%%%%%%
%%%%#####%%%%%%%%%%%
%%%%#   #%%%%%%%%%%%
%%%%#E  #%%%%%%%%%%%
%%###  E###%%%%%%%%%
%%#  E  E #%%%%%%%%%
### # ### #%%%######
#   # ### #####  XX#
# E  E           XX#
##### ##### #P#  XX#
%%%%#       ########
%%%%#########%%%%%%%
%%%%%%%%%%%%%%%%%%%%
%%%%%%%%%%%%%%%%%%%%