%%%%%%%%%%%%%%%%%%%%
%##########%%%%%%%%%
%##########%%%%%%%%%
%####     #%%%%%%%%%
%####     #%%%%%%%%%
%#X  E    #%%%%%%%%%
%#   A    #%%%%%%%%%
%# X E   P#%%%%%%%%%
%##########%%%%%%%%%
%%%%%%%%%%%%%%%%%%%%
%%%%%%%%%%%%%%%%%%%%
%%%%%%%%%%%%%%%%%%%%
%%%%%%%%%%%%%%%%%%%%
%%%%%%%%%%%%%%%%%%%%
%%%%%%%%%%%%%%%%%%%%